111111111111111111
1C00000100C0000001
100000010000000C01
100000010001111101
1P0000010001000101
10000001000101C101
100000000101011101
100000000101000001
100000101101111111
1C000010C1000000E1
111111111111111111
