1111111111111111111111
1P00000100000000000C01
1000000100000000000001
1000000100000000000001
1000000001000000000001
1000000001000000000001
1000000001000000000001
1C000000010000000000E1
1111111111111111111111
