111111111111111111
1C00000100C0000001
100000010000000C01
100000010000000001
1P0000010000000001
100000010000000001
100000000100000001
100000000100000001
100000000100000001
1C00000001000000E1
111111111111111111
