111111111111111111111111111111111111111111111111111111111111111111111111111
1P0100010000000111100000C111110010001000000000000C11111001000100000000C1111
100C00000111000001000C111100C00000111000001000C111100C00000111000001000C111
1101110000011000110000C111101110000011000110000C111101110000011000110000C11
10001000000000001100000C110001000000000001100000C110001000000000001100000C1
100010000001100011100000110001000000110001110000000000100000011000111000001
100010000100000001110000000001000010000000111000000000100001000000011100001
10000C001100C00C00111000000000C001100C00C00111000110000C001100C00C001110001
111000011000000000111100111100001100000000011110011110000110000000001111001
10011101000C00100000000C110011101000C00100000000C110011101000C00100000000C1
10001000000000000C0000000000000000000000000C00011110000000000000000C0001111
10000111111000100000111C110C00111111000100000111C110C00111111000100000111C1
100000011100000000111C001100000011100000000111C000000000011100000000111C001
100111111000011100000000000011111100001110000000011001111110000111000000001
100010000000000000000000000000000000000000000000011000000000000000000000001
111100C001110001011100001111100C001110001011100001111100C001110001011100001
100000000111000100000011110000000011100010000001111000000001110001000000111
10011100011100110001CC00110011100011100110001CC00110011100011100110001CC001
100000010000011000010000110000001010011100000000E11000000100000110000110001
10010001000000000000C111110010001010010000000C111110010001000000000010C1111
100C00000111000001000C111100C00000111100001000C111100C00000111000001000C111
10001000000000001100000C110001000000000001100000C110001000100000001100000C1
100010000001100011100000110001000000110001110000000000100000011000111000001
100010000100000001110000110001000010000000111000011000100001000000011100001
10000C001100C00C00111000110010C001100C00C00111000110000C001100C00C001110001
111000011000000000111100111100001100000000011110011110000110000000001111001
10011101000C00100000000C110011101000C00100000000C110011101000C00100000000C1
10000100000000000C0000000000000000000000000C00011000000000000000000C0001111
10000111111000100000111C110C00111111000100000111C000C00111111000100000111C1
100000011100000000111C001100000011100000000111C000000000011100000000111C001
100111111000011100000000000011111100001110000000000001111110000111000000001
100010000001100001100000000000000110000000110000011000000000000000000000001
111100C001110001011100001111100C001110001011100001111100C001110001011100001
100000000111000100000011110000000011100010000001111000000001110001000000111
10011100011100110001CC00110011100011100110001CC00110011100011100110001CC001
100000010000011000010000110000001000001100001000011000000100000110000100001
111111111111111111111111111111111111111111111111111111111111111111111111111
